MODE 1
SIZE 11/30
LIMIT 0/30
COLOR LIMIT 5
STARS 2000/3500/5000
0 0 0 0 0 0 0 0 0 0 0
0 0 6 6 6 6 0 0 0 0 0
0 6 6 6 6 6 6 0 0 6 0
0 6 6 6 6 6 6 6 6 0 0
0 6 6 6 0 6 6 6 0 0 0
0 6 6 6 0 7 6 6 6 6 6
0 0 0 0 6 0 0 0 0 6 0
0 0 0 0 6 6 6 6 6 0 0
0 0 0 0 0 0 0 0 0 0 0
0 0 0 0 0 0 0 0 0 0 0
0 0 0 0 0 0 0 0 0 0 0
0 0 0 0 0 0 0 0 0 0 0
0 0 0 0 0 0 0 0 0 0 0
0 0 0 0 0 0 0 0 0 0 0
0 0 0 0 0 0 0 0 0 0 0
0 0 0 0 0 0 0 0 0 0 0
0 0 0 0 0 0 0 0 0 0 0
0 0 0 0 0 0 0 0 0 0 0
0 0 0 0 0 0 0 0 0 0 0
0 0 0 0 0 0 0 0 0 0 0
0 0 0 0 0 0 0 0 0 0 0
0 0 0 0 0 0 0 0 0 0 0
0 0 0 0 0 0 0 0 0 0 0
0 0 0 0 0 0 0 0 0 0 0
0 0 0 0 0 0 0 0 0 0 0
0 0 0 0 0 0 0 0 0 0 0
0 0 0 0 0 0 0 0 0 0 0
0 0 0 0 0 0 0 0 0 0 0
0 0 0 0 0 0 0 0 0 0 0
0 0 0 0 0 0 0 0 0 0 0