MODE 0
SIZE 11/30
LIMIT 0/30
COLOR LIMIT 5
STARS 2000/3500/5000
6 6 6 6 5 5 3 2 5 5 6
6 6 4 4 5 5 2 2 2 6 3
1 1 6 4 6 5 5 2 2 2 6
1 6 4 6 5 5 2 3 2 6 3
1 1 4 4 6 5 6 3 2 6 6
0 6 4 6 5 5 6 3 6 6 3
6 6 6 6 5 5 6 6 6 1 3
6 6 6 6 6 4 6 6 3 1 1
2 2 6 6 6 6 4 6 6 3 1
2 1 1 1 6 1 4 3 3 1 1
1 1 1 2 1 6 1 6 2 3 1
0 0 0 0 0 0 0 0 0 0 0
0 0 0 0 0 0 0 0 0 0 0
0 0 0 0 0 0 0 0 0 0 0
0 0 0 0 0 0 0 0 0 0 0
0 0 0 0 0 0 0 0 0 0 0
0 0 0 0 0 0 0 0 0 0 0
0 0 0 0 0 0 0 0 0 0 0
0 0 0 0 0 0 0 0 0 0 0
0 0 0 0 0 0 0 0 0 0 0
0 0 0 0 0 0 0 0 0 0 0
0 0 0 0 0 0 0 0 0 0 0
0 0 0 0 0 0 0 0 0 0 0
0 0 0 0 0 0 0 0 0 0 0
0 0 0 0 0 0 0 0 0 0 0
0 0 0 0 0 0 0 0 0 0 0
0 0 0 0 0 0 0 0 0 0 0
0 0 0 0 0 0 0 0 0 0 0
0 0 0 0 0 0 0 0 0 0 0
0 0 0 0 0 0 0 0 0 0 0