MODE 0
SIZE 11/30
LIMIT 0/60
COLOR LIMIT 5
STARS 4500/8000/10000
0 1 1 1 1 6 6 6 0 0 0
1 1 1 1 6 6 3 0 0 0 0
3 3 3 3 4 3 4 4 0 0 0
0 0 3 0 0 0 0 4 4 0 0
0 0 0 0 3 3 3 3 3 4 0
0 0 3 3 3 3 4 4 4 4 0
0 0 0 3 3 3 3 3 3 0 0
0 6 6 6 6 6 0 0 0 0 0
0 0 6 6 6 0 0 0 0 0 0
0 6 6 6 6 0 0 0 0 0 0
0 0 6 6 6 6 0 0 0 0 0
0 6 6 6 6 0 0 0 0 0 0
0 0 6 6 0 0 0 0 0 0 0
0 0 6 6 0 0 0 0 0 0 0
0 0 6 6 6 0 0 0 0 0 0
0 0 6 6 6 0 6 0 0 0 0
0 0 0 0 6 6 6 6 6 0 0
0 0 0 0 0 6 0 6 0 0 0
0 0 0 0 6 6 0 0 0 0 0
0 0 0 0 6 0 0 0 0 0 0
0 6 6 6 6 0 6 6 0 0 0
0 6 0 6 0 6 0 6 0 0 0
0 0 6 0 6 6 0 6 0 0 0
0 0 6 0 0 0 6 0 0 0 0
0 0 0 6 0 0 6 0 6 0 0
0 0 0 6 0 6 6 6 0 0 0
0 0 0 0 6 6 6 6 0 0 0
0 0 0 0 6 6 6 0 0 0 0
0 0 0 0 0 0 0 0 0 0 0
0 0 0 0 0 0 0 0 0 0 0